XXXXXXXXXXXXXXXXXXXXXXXXXXXXXXXXXXXXXXXXXXXXXXXXXXXXXXXXXXXXXXXXXXXXXXX
XXX XXXXX    XXXXXXXX     XXXXXXXX     XXXXXXXX        XXXXXXXXXXX   XX
X         X        XX  XX   XXXXX  XX   XXXXX  XXXXXX  XXXX    XXXXX  X
XXXX    XXXX  XXX      XXX        XXXX  XXX   XXXXXX  XXX   XX       XX
XXXXXXXXXXXX  XXXXXXXXXXXXXXXXXXXXXXXX   XX    XXXXXXXXX  XXXXXXX XX  X
XX     XXXXXX  XX        XX         XXXX XXXXX            XXXXXXXX   XX
X  XX       XX     XXXX     XX  XX  XXXX    XXX    XXXXXXXX      XXX  X
X XXXX  XXX XXXX  XXXXXXXXXXX  XXX   XXXXXX  XX  XXXXXXX    XXXX  XX  X
XX XX  XXXXXXXX     XXXXXX      XXXX   XXXX      XXXXXX  XXXXXXX XXXX X
XX  XX   XXXXX  XXX     XXXXXX  XXXXXX   XXXXXXXXXXX       XXX   XX   X
XXX  XXX   XX  XXXXXXXX     XXX     XXXX    XXXXXXXXXXXXXX XXX  XXX  XX
XXXX XXXXXX   XXX     XXXXX XXXXXXX XXXXXXX  XXXXX      XXXXXXX  XX XXX
XXX  XXXXXXXX XXX  X    XXX  XXXXXX XXXXXX  XXX XX  XXX    XXXXX    XXX
XXX XXXX      XXX XX XX  XXX  X         XX XXXX      XXXXX    XXX XX  X
X  XXX   XX       XX  XX  XX  X         XX  XXXXXXX  XXXXXXXX XXX XXX X
X  XXX XXXXX XXXXXXXX XXXXX  XX    E    XX     XXX  XXXXX     XX  XX  X
XX XXX  XXXX XXXXXXXX        XX         XXXX  XXXX    XXX XXXXXX  XXX X
XX  XXXXXXX  XXXXXXXXXXXX  XXXX         XXX  XXXXXXXX   XXXXXXX  XXX  X
XXX  XX     XXXX       XX   XXXXXXX XXXXXXX   XXXXXXXXX XXXX    XXXX XX
XXXX    XXXXXXX  XXXX   XXX  XXXXX  XXXX    XXXXX  XXXX   X  XXXXXX  XX
XXXXXXXXXXXXXXXX XXXXXX XXXX        XXXX  XXXXX      XXXX   XXXXX    XX
XXXXXX    XXX    XXXXXX   XXXXXXXX       XXXX   XXX  XXXXX     XXXX XXX
XXXXX  XX      XXXXXXXXXX       XXXXXXXXXXX   XXXX   XXXXXXXXX       XX
XXX   XXXXXXX  XXXXXXXXXXXXXXX       XXXX   XXXXX  X  XXXXXXXXXXXXX   X
XX  XXXXXXXXXX  X XXXXX   XXXXXXXX         XXX    XXXXXXXX    XXXXXX  X
XX XXXX    XXXXX    X   XXXXXXXXXXXXXXX   XXX  XXXXX XXX   XX    XXX  X
XX XXXX XX  XXXXXXX   XXXXX          XX  XXX    XX   XXXX XXXX  XXX   X
XX  XXX XXX   XXXXX  XXXXX  XXXXXXX       XXXX     XXXX     XXXXXX   XX
XXX X   XXXXX  XXXXXXXXXX  XXXXXXX  XXX    XXXXXXXXXXX  XXX  XX     XXX
XXXX  XXXXXXXX            XXXXXXX     XXX              XXXXX     XXXXXX
XXXXXXXXXXXXXXXXXXXXXXXXXXXXXXXXX  S  XXXXXXXXXXXXXXXXXXXXXXXXXXXXXXXXX
